<b>الميزات:</b>

- الوصول السريع للتطبيقات المفضلة: اعرض تطبيقاتك الأكثر استخدامًا على الشاشة الرئيسية بتنسيق نصي للوصول السريع، مما يبسط عملياتك.
- إخفاء التطبيقات: قم بإخفاء التطبيقات التي لا ترغب في ظهورها بسهولة، مما يحافظ على شاشتك الرئيسية نظيفة ومركزة على المحتوى الأساسي.
- إعادة تسمية التطبيقات: خصص تطبيقاتك بأسماء فريدة تتزامن بسلاسة بين التطبيقات المفضلة وجميع التطبيقات.
- القفل: قم بتأمين خصوصيتك وبياناتك باستخدام قفل بصمة الإصبع للتطبيقات والإعدادات المحددة.
- لا توجد أذونات إنترنت: لا يستخدم التطبيق أي أذونات إنترنت، مما يضمن بقاء بياناتك خاصة.
- تقارير الأعطال: أرسل تقارير الأعطال عبر البريد الإلكتروني، بما في ذلك ملفات السجل لاستكشاف الأخطاء وإصلاحها بفعالية.

<b>التخصيص الشخصي:</b>

- ألوان الخطوط: خصص ألوان الخطوط باستخدام أداة اختيار الألوان الخاصة بنا.
- الموضع: قم بمحاذاة التاريخ والوقت والتطبيقات إلى اليسار أو الوسط أو اليمين.
- المسافة البادئة: اضبط المسافة البادئة بين التطبيقات المفضلة وجميع التطبيقات.
- حجم الخط: اضبط حجم الخط لكل عنصر على الشاشة الرئيسية.
- تبديل العناصر: تحكم في تفضيلات العرض على الشاشة الرئيسية.

<b>الإيماءات الممكنة تشمل:</b>

- إيماءات السحب: تنقل عن طريق السحب في اتجاهات مختلفة (أعلى، أسفل، يسار، يمين) للوصول إلى ميزات متنوعة أو الانتقال بين الشاشات.
- النقر المزدوج: انقر بسرعة على الشاشة مرتين لتنفيذ إجراء محدد مسبقًا أو تنشيط ميزة.
- التفاعل مع الساعة: انقر على الساعة لعرض معلومات إضافية مثل المنبهات أو الساعة العالمية.
- التفاعل مع التاريخ: انقر على التاريخ لفتح تطبيق التقويم للجدولة والتخطيط.
- أيقونة البطارية: انقر على أيقونة البطارية للوصول إلى تفاصيل استخدام البطارية.

<b>الإجراءات الممكنة تشمل:</b>

- فتح تطبيق محدد: قم بتشغيل أي تطبيق تختاره على الفور للوصول السلس إلى مفضلاتك.
- عرض قائمة التطبيقات: اعرض وادِر تطبيقاتك المثبتة بكفاءة من خلال عرض قائمة شاملة.
- قفل الشاشة: قم بتأمين جهازك وحماية خصوصيتك بقفل شاشة سريع ومريح.
- إظهار التطبيقات المفتوحة مؤخرًا: الوصول إلى التطبيقات المستخدمة مؤخرًا بسهولة لتعدد المهام السريع.
- الوصول إلى درج الإشعارات: افتح درج الإشعارات بنقرة واحدة للتحقق من التحديثات والتنبيهات.
- الإعدادات السريعة: أدر إعدادات الجهاز بسرعة عن طريق الوصول إلى الإعدادات السريعة مباشرة من الشاشة الرئيسية.
- مربع حوار الطاقة: تحكم في خيارات الطاقة مثل إعادة التشغيل وإيقاف التشغيل والمزيد بسهولة باستخدام مربع حوار الطاقة.
- التقاط لقطة شاشة: التقط شاشتك على الفور لحفظ ومشاركة المعلومات واللحظات المهمة.
- تعطيل الإيماءات: قم بتعطيل إيماءات محددة مؤقتًا أو دائمًا لتخصيص تجربة التفاعل مع جهازك.

<b>الأذونات:</b>

- android.permission.SET_WALLPAPER: هذا الإذن مطلوب للتطبيق لتغيير أو تعيين خلفية الجهاز. يسمح للتطبيق بتعديل الخلفية المعروضة على الشاشة الرئيسية أو شاشة القفل برمجيًا.
- android.permission.EXPAND_STATUS_BAR: يسمح هذا الإذن للتطبيق بتوسيع أو طي شريط الحالة، مما يوفر وظائف للتفاعل مع الإعدادات السريعة أو الإشعارات.
- android.permission.USE_BIOMETRIC: هذا الإذن مطلوب للتطبيق لاستخدام طرق المصادقة البيومترية (مثل بصمة الإصبع أو التعرف على الوجه أو مسح القزحية).
- android.permission.VIBRATE: يسمح هذا الإذن للتطبيق بالتحكم في اهتزاز الجهاز لتقديم ردود فعل لمسية (haptic feedback)، والتي يمكن استخدامها للتنبيهات أو الإشعارات أو التفاعلات المخصصة للمستخدم داخل التطبيق.
- android.permission.QUERY_ALL_PACKAGES: يسمح هذا الإذن للتطبيق بالاستعلام وعرض قائمة بجميع التطبيقات المثبتة على الجهاز. يمكن أن يثير هذا الإذن مخاوف تتعلق بالخصوصية ويتم مراجعته غالبًا من قبل Google Play للاستخدام المناسب.
- android.permission.REQUEST_DELETE_PACKAGES: يسمح هذا الإذن للتطبيق بطلب إلغاء تثبيت الحزم (التطبيقات) من الجهاز.
- com.android.alarm.permission.SET_ALARM: هذا الإذن ضروري للتطبيق لضبط المنبهات على الجهاز. يسمح للتطبيق بجدولة المنبهات التي سيتم تشغيلها في أوقات محددة، ويستخدم عادة بواسطة تطبيقات الساعة أو التذكير أو المهام.

لمزيد من التفاصيل، يرجى زيارة صفحة <a href="https://github.com/DroidWorksStudio/EasyLauncher/blob/main/README.md">Github</a>.